Anastasia Clara Blackwell	witch
Arya Natalie Davenport	hunterwitch
Aurora Vivienne Boucher	hybrid
Bernadetta Ottavia Conti	vegetarian
Chiara Ilaria Lombardi	human
Daniel Apollo Dreschler	hybrid
Declan Aidan Bernhard	hybrid
Deianeira Cecilia Lund	human
Felicity Gemma Montgomery	human
Harper Adriana Esposito	hybrid
Harrison James Whitmore	hybrid
Hera Melody Harlow	hunter
Katrina Deva Bianchi	vampirehunter
Lennon Therasia Windsor	hunter
Leone Battista Dalmonte	hunter
Salvatore Edoardo Moretti	werewolf
Theodore Percival Hayes	human
Valeria Euphemia Greco	vegetarian
West Elliot Harlow	hunter
Rodrigo Abeyta	human
Alessandro Rossi	hybrid
Coralie Francesca Romano	supernaturalhuman
Demetria Nadira Harlow	hunter
Zachariah Gideon Lund	human
Joshua William Lund	human
Dante Konstantin Lund	human
Florence Elise Winslow	witch
Carmen Iscariot Denali	supernaturalhuman
Juliette Claire Lefèvre	witch
Emery Herman Bernhard	hybrid
Camille Lillian Boucher	hybridhunter
Charlotte Iris Dreschler	volturi
Hazel Adeline Boucher	supernaturalhuman
Søren Ragnar Lindström	werewolf
Michael Romeo Harlow	hunter
Cassandra Willa Dreschler	witch
Randall Frank Dreschler	vegetarian
Nathaniel Dean Harlow	hunter
Demetri Lorenzo Volturi	volturi
Veronique Helena Dreschler	vampirewitch
Alexis Feiyu King	witch
Jonathan Fort Harlow	hunter
Felix Constantine Volturi	volturi
Myrtle Maeve Gray	vegetarian
Bianca Juliett Harlow-Bakir	human
Oliver Noah Harlow	hunter
Reinhardt Gustav Lund	hunter
Isadora Vanessa Dragoumis-Lund	human
Theofania Maria Caras-Dragoumis	human
Eleni Karissa Aetós-Lund	human
Atticus Orfeas Lund	human
Alastar Zander Lund	human
Samir Bakir	human
Thomas Harlow	vegetarian
Matthew Harlow	hunter
Damir Harlow	human
Olivia Harriet Calloway	vampirewitch
Mariana Lucía Gonzalez	human
Kurt Hartwin Lund	human
Beatrice Johanna Wolf	human
Scarlett Rosemary Lund	human
Venetia Irida Dragoumis	human
Matteo Rossi	human
Jeremiah Rhys Sinclair	human
Alessandra Maria Mancini-Bianchi	hunter
Niccolò Davide Bianchi	hunter
The British Royal Family	human
Sabrina Miranda Volturi	human
Dominic Lucien Harrington	human
Maxime Julien Delacroix	human
Gabriella Harper Rhodes	human
Layla Eman Bakir	human
